PPPPPPPPPPPPPPPPPPPPPPPPPPPPPPPPPPPPPPPPPPPPPPPPPPPPPPPPPPPPPPPPPPPPPPPPPPPPPPPPPPPPPPPPPPPPPPPPPPPPPPPPPPPPPPPPPPPPPPPPPPPPPPPPPPPPPPPPPPPPPPPPPPPPPPPPPPPPPPPPPPPPPPPPPPPPPPPPPPPPPPPPPPPPPPPPPPPPPPPPPPPPPPPPPPPPPPPPPPPPPPPPPPPPPPPPPPPPPPPPPPPPPPPPPPPPPPPPPPPPPPPPPPPPPPPPPPPPPPPP
P                                      P                                                                                                                                                                                                                                               P
P                                      P                                                                                                                                                                                                                                               P
P                                      P                                                                                                                                                                                                                                               P
P                                      P                    PPPPP                                                                                                                                                                                                                      P
P                                      P                                                                                                                                                                                                                                               PPPPPPP
P                                      P                                                                            PPPPPPPPPP                                                                      PPPPPPPPPPPPP                                                                            P
PPPPPPPPPPPPPPPPPPPPPPPP               P                                                                                                                                                                                                                                                     P
                       P               P                                                                                                                                                                                                         PPPPPPPPPP                                  P
                       P               P                                                                                                                                                                                                                                               P     P
                       P               P                                PPPPPP                                                                              PPPPPPP                                                                                                                    P     P
                       P               P                                                            PPPPPPP                                                                                                                                                                            P     P
                       P               P                                                                                                                                        PPPPPP                                                                                                 P     P
                       P               P                                                                                                                                                                                                                                               P     P
                       P               P                                                                                                                                                                PPPP                                                                           P     P
                       P               P                                    PPPPPPPPP                                                                                                                                                                                                  P     P
                       P               P                                                                                                                                                                                                                                               P     P
                       P               P                                                                                                                                                                                                                                               P     P
                       P               P    PPPPP                                                                                                                                                                                                                                      P     P
                       P               P                                                                                    PPPPPPPPPPP                                                                                         PPPPPPPPPPPPPPPPP                                      P     P
                       P               P                                                                                                                                                                                                                                               P     P
                       P               P                            PPPPP                   PPPPP                                                                       PPPPPP                                                                                                         P     P
                       P               P                                                                                                                                                                                                                                               P     P
                       P               P                                                                                                                                                                                                                                               P     P
                       P                                                                                                                                                                                                                                                               P     P
                       P                                                                            PPPPP                                                                        PPPPPPPPPPPPP                                                                                         P     P
                       P                                                                                                                                                                                                                                                               P     P
                       P                                                                                                                                                                                                                                                               P     P
                       PGMGMGMGGMGMGGMGMGMGGMGMGGMGMGMGGEEEEEEEEEEEEEEEEEEEEEEEEEEEEEEEEEEEEEEEEEEEEEEEEEEEEEEEEE     EEEEEEEEEEEEEEEEEEEEEEEEEEEEEEEEEEEEEEEEEEEEEEEEEEEEEEEEEEEEEEEE    EEEEEEEEEEEEEEEEEEEEEEEEEEEEEEEEEE      EEEEEEEEEEEEEEEEEEEEEEEEEEEEEEEE          EEEEEEEEEEEP     P

